111111111111111111111111111111111111111111111111111111111
140000001000000000007000000004000000000000000000100000061
101111101011111101111111111101111111111101111110101111101
101000000000000000000000000000000000000600000000000000101
101010111111111111111010111101111111111111111111111010101
101010050000010000000010000000000000100000000000000010101
101010101111010111111111111111111110101111110111101010101
101010100000000050000000000000000000400000000000001010101
101010111110101010111010111121111010111010101011111010101
10101011111010101000101013g333g31010100010101000000010001
10001000000010101010001013g333g31010001010101011111410101
101010111110101010101110111111111011101010101011111010101
101010100000000400007000000000000000000000000000001010101
101010101111010111111111111101111111111110101111101010101
101010000000010000000000000000000000000000100000000010101
101010111111111111111111111101111111111111111111111010101
101000000000000000000100000000000001000000000000400000101
101111101011111111110101111101111101011111111110101111101
1400000010000000000000000000p0000000000070000000100000051
111111111111111111111111111111111111111111111111111111111

0 ball
1 wall
2 gate          (only one)
p pacman        (only one)
g ghost         (only four)
3 blank
4 power ball
5 power ball 02
6 power ball 03
7 power ball 04
