1111111111111111111111111111111111111111111111111111111111
1400000000000000000000000005114000000000000000000000000051
1011111101111111111101111110110111111011111111111011111101
1000004100000000000001400000110000041000000000000014000001
1011110101111101111101011110110111101011111011111010111101
1000010100000000000001010000110000101000000000000010100001
1011010101111101111101010110110110101011111011111010101101
1000010000000000000000010000110000100000000000000000100001
1011010101011121110101010110110110101010111111101010101101
100000010101g333g10101010110110000001010111111101010101101
101101010101g333g10101000000110110101010111111101010000001
1011010101011111110101010110110110101010111111101010101101
1000010000000000000000010000110000100000000000000000100001
1011010101111101111101010110110110101011111011111010101101
1000010100000000000001010000110000101000000000000010100001
1011110101111101111101011110110111101011111011111010111101
1000004100000000000001400000110000041000000000000014000001
1011111101111111111101111110110111111011111111111011111101
14000000000000p0000000000006004000000000000000000000000061
1111111111111111111111111111111111111111111111111111111111